"filename", "language", "AL", "alapp", "XML", "comment", "blank", "total"
"c:\Users\jh\OneDrive - Scanpan\Scanpan (7.1.2015)\Development\SCANPAN Internal CodeBase\SCANPAN_SCANPAN CODEBASE Internal Development_1.0.0.48.app", "alapp", 0, -4148, 0, 0, -22, -4170
"c:\Users\jh\OneDrive - Scanpan\Scanpan (7.1.2015)\Development\SCANPAN Internal CodeBase\SCANPAN_SCANPAN CODEBASE Internal Development_1.0.23.7190832.app", "alapp", 0, -4554, 0, 0, -22, -4576
"c:\Users\jh\OneDrive - Scanpan\Scanpan (7.1.2015)\Development\SCANPAN Internal CodeBase\SCANPAN_SCANPAN CODEBASE Internal Development_1.0.23.7190833.app", "alapp", 0, -4139, 0, 0, -22, -4161
"c:\Users\jh\OneDrive - Scanpan\Scanpan (7.1.2015)\Development\SCANPAN Internal CodeBase\SCANPAN_SCANPAN CODEBASE Internal Development_1.0.23.7190835.app", "alapp", 0, -4138, 0, 0, -21, -4159
"c:\Users\jh\OneDrive - Scanpan\Scanpan (7.1.2015)\Development\SCANPAN Internal CodeBase\SCANPAN_SCANPAN CODEBASE Internal Development_1.0.23.7190855.app", "alapp", 0, -4147, 0, 0, -22, -4169
"c:\Users\jh\OneDrive - Scanpan\Scanpan (7.1.2015)\Development\SCANPAN Internal CodeBase\SCANPAN_SCANPAN CODEBASE Internal Development_1.0.23.7191041.app", "alapp", 0, -4137, 0, 0, -22, -4159
"c:\Users\jh\OneDrive - Scanpan\Scanpan (7.1.2015)\Development\SCANPAN Internal CodeBase\SCANPAN_SCANPAN CODEBASE Internal Development_1.0.23.7191132.app", "alapp", 0, -4152, 0, 0, -22, -4174
"c:\Users\jh\OneDrive - Scanpan\Scanpan (7.1.2015)\Development\SCANPAN Internal CodeBase\SCANPAN_SCANPAN CODEBASE Internal Development_1.0.23.7191141.app", "alapp", 0, -4180, 0, 0, -20, -4200
"c:\Users\jh\OneDrive - Scanpan\Scanpan (7.1.2015)\Development\SCANPAN Internal CodeBase\SCANPAN_SCANPAN CODEBASE Internal Development_1.0.23.7191325.app", "alapp", 0, -4204, 0, 0, -17, -4221
"c:\Users\jh\OneDrive - Scanpan\Scanpan (7.1.2015)\Development\SCANPAN Internal CodeBase\SCANPAN_SCANPAN CODEBASE Internal Development_1.0.23.7191330.app", "alapp", 0, -4115, 0, 0, -20, -4135
"c:\Users\jh\OneDrive - Scanpan\Scanpan (7.1.2015)\Development\SCANPAN Internal CodeBase\SCANPAN_SCANPAN CODEBASE Internal Development_1.0.23.7191333.app", "alapp", 0, -4154, 0, 0, -22, -4176
"c:\Users\jh\OneDrive - Scanpan\Scanpan (7.1.2015)\Development\SCANPAN Internal CodeBase\SCANPAN_SCANPAN CODEBASE Internal Development_1.0.23.7261250.app", "alapp", 0, 4144, 0, 0, 27, 4171
"c:\Users\jh\OneDrive - Scanpan\Scanpan (7.1.2015)\Development\SCANPAN Internal CodeBase\SCANPAN_SCANPAN CODEBASE Internal Development_1.0.23.7261348.app", "alapp", 0, 4288, 0, 0, 21, 4309
"c:\Users\jh\OneDrive - Scanpan\Scanpan (7.1.2015)\Development\SCANPAN Internal CodeBase\SCANPAN_SCANPAN CODEBASE Internal Development_1.0.23.7261529.app", "alapp", 0, 4230, 0, 0, 23, 4253
"c:\Users\jh\OneDrive - Scanpan\Scanpan (7.1.2015)\Development\SCANPAN Internal CodeBase\SCANPAN_SCANPAN CODEBASE Internal Development_1.0.23.7271419.app", "alapp", 0, 4224, 0, 0, 18, 4242
"c:\Users\jh\OneDrive - Scanpan\Scanpan (7.1.2015)\Development\SCANPAN Internal CodeBase\SCANPAN_SCANPAN CODEBASE Internal Development_1.0.23.7280914.app", "alapp", 0, 4245, 0, 0, 19, 4264
"c:\Users\jh\OneDrive - Scanpan\Scanpan (7.1.2015)\Development\SCANPAN Internal CodeBase\SCANPAN_SCANPAN CODEBASE Internal Development_1.0.23.7280956.app", "alapp", 0, 4203, 0, 0, 20, 4223
"c:\Users\jh\OneDrive - Scanpan\Scanpan (7.1.2015)\Development\SCANPAN Internal CodeBase\SnapshotDebugging.al", "AL", 0, 0, 0, 0, -1, -1
"c:\Users\jh\OneDrive - Scanpan\Scanpan (7.1.2015)\Development\SCANPAN Internal CodeBase\old_app_codebase\SCANPAN_SCANPAN CODEBASE Internal Development_1.0.0.48.app", "alapp", 0, 14, 0, 0, -1, 13
"c:\Users\jh\OneDrive - Scanpan\Scanpan (7.1.2015)\Development\SCANPAN Internal CodeBase\old_app_codebase\SCANPAN_SCANPAN CODEBASE Internal Development_1.0.23.7190832.app", "alapp", 0, 4554, 0, 0, 22, 4576
"c:\Users\jh\OneDrive - Scanpan\Scanpan (7.1.2015)\Development\SCANPAN Internal CodeBase\old_app_codebase\SCANPAN_SCANPAN CODEBASE Internal Development_1.0.23.7190833.app", "alapp", 0, 4139, 0, 0, 22, 4161
"c:\Users\jh\OneDrive - Scanpan\Scanpan (7.1.2015)\Development\SCANPAN Internal CodeBase\old_app_codebase\SCANPAN_SCANPAN CODEBASE Internal Development_1.0.23.7190835.app", "alapp", 0, 4138, 0, 0, 21, 4159
"c:\Users\jh\OneDrive - Scanpan\Scanpan (7.1.2015)\Development\SCANPAN Internal CodeBase\old_app_codebase\SCANPAN_SCANPAN CODEBASE Internal Development_1.0.23.7190855.app", "alapp", 0, 4147, 0, 0, 22, 4169
"c:\Users\jh\OneDrive - Scanpan\Scanpan (7.1.2015)\Development\SCANPAN Internal CodeBase\old_app_codebase\SCANPAN_SCANPAN CODEBASE Internal Development_1.0.23.7191041.app", "alapp", 0, 4137, 0, 0, 22, 4159
"c:\Users\jh\OneDrive - Scanpan\Scanpan (7.1.2015)\Development\SCANPAN Internal CodeBase\old_app_codebase\SCANPAN_SCANPAN CODEBASE Internal Development_1.0.23.7191132.app", "alapp", 0, 4152, 0, 0, 22, 4174
"c:\Users\jh\OneDrive - Scanpan\Scanpan (7.1.2015)\Development\SCANPAN Internal CodeBase\old_app_codebase\SCANPAN_SCANPAN CODEBASE Internal Development_1.0.23.7191141.app", "alapp", 0, 4180, 0, 0, 20, 4200
"c:\Users\jh\OneDrive - Scanpan\Scanpan (7.1.2015)\Development\SCANPAN Internal CodeBase\old_app_codebase\SCANPAN_SCANPAN CODEBASE Internal Development_1.0.23.7191325.app", "alapp", 0, 4204, 0, 0, 17, 4221
"c:\Users\jh\OneDrive - Scanpan\Scanpan (7.1.2015)\Development\SCANPAN Internal CodeBase\old_app_codebase\SCANPAN_SCANPAN CODEBASE Internal Development_1.0.23.7191330.app", "alapp", 0, 4115, 0, 0, 20, 4135
"c:\Users\jh\OneDrive - Scanpan\Scanpan (7.1.2015)\Development\SCANPAN Internal CodeBase\old_app_codebase\SCANPAN_SCANPAN CODEBASE Internal Development_1.0.23.7191333.app", "alapp", 0, 4195, 0, 0, 19, 4214
"c:\Users\jh\OneDrive - Scanpan\Scanpan (7.1.2015)\Development\SCANPAN Internal CodeBase\old_app_codebase\SCANPAN_SCANPAN CODEBASE Internal Development_1.0.23.7191500.app", "alapp", 0, 4124, 0, 0, 21, 4145
"c:\Users\jh\OneDrive - Scanpan\Scanpan (7.1.2015)\Development\SCANPAN Internal CodeBase\old_app_codebase\SCANPAN_SCANPAN CODEBASE Internal Development_1.0.23.7200931.app", "alapp", 0, 4073, 0, 0, 23, 4096
"c:\Users\jh\OneDrive - Scanpan\Scanpan (7.1.2015)\Development\SCANPAN Internal CodeBase\old_app_codebase\SCANPAN_SCANPAN CODEBASE Internal Development_1.0.23.7200953.app", "alapp", 0, 4092, 0, 0, 23, 4115
"c:\Users\jh\OneDrive - Scanpan\Scanpan (7.1.2015)\Development\SCANPAN Internal CodeBase\old_app_codebase\SCANPAN_SCANPAN CODEBASE Internal Development_1.0.23.7201511.app", "alapp", 0, 4109, 0, 0, 23, 4132
"c:\Users\jh\OneDrive - Scanpan\Scanpan (7.1.2015)\Development\SCANPAN Internal CodeBase\old_app_codebase\SCANPAN_SCANPAN CODEBASE Internal Development_1.0.23.7241007.app", "alapp", 0, 4140, 0, 0, 24, 4164
"c:\Users\jh\OneDrive - Scanpan\Scanpan (7.1.2015)\Development\SCANPAN Internal CodeBase\old_app_codebase\SCANPAN_SCANPAN CODEBASE Internal Development_1.0.23.7241500.app", "alapp", 0, 4172, 0, 0, 19, 4191
"c:\Users\jh\OneDrive - Scanpan\Scanpan (7.1.2015)\Development\SCANPAN Internal CodeBase\old_app_codebase\SCANPAN_SCANPAN CODEBASE Internal Development_1.0.23.7251021.app", "alapp", 0, 4125, 0, 0, 28, 4153
"c:\Users\jh\OneDrive - Scanpan\Scanpan (7.1.2015)\Development\SCANPAN Internal CodeBase\old_app_codebase\SCANPAN_SCANPAN CODEBASE Internal Development_1.0.23.7251129.app", "alapp", 0, 4171, 0, 0, 28, 4199
"c:\Users\jh\OneDrive - Scanpan\Scanpan (7.1.2015)\Development\SCANPAN Internal CodeBase\old_app_codebase\SCANPAN_SCANPAN CODEBASE Internal Development_1.0.23.7251337.app", "alapp", 0, 4123, 0, 0, 22, 4145
"c:\Users\jh\OneDrive - Scanpan\Scanpan (7.1.2015)\Development\SCANPAN Internal CodeBase\old_app_codebase\SCANPAN_SCANPAN CODEBASE Internal Development_1.0.23.7260954.app", "alapp", 0, 4152, 0, 0, 25, 4177
"c:\Users\jh\OneDrive - Scanpan\Scanpan (7.1.2015)\Development\SCANPAN Internal CodeBase\src\Page Ext FactBox\SalesLineFactBox.PageExt.al", "AL", 51, 0, 0, 10, 8, 69
"c:\Users\jh\OneDrive - Scanpan\Scanpan (7.1.2015)\Development\SCANPAN Internal CodeBase\src\codeunit\CompanyTestDetection.Codeunit.al", "AL", 0, 0, 0, 5, 0, 5
"c:\Users\jh\OneDrive - Scanpan\Scanpan (7.1.2015)\Development\SCANPAN Internal CodeBase\src\codeunit\ScanpanMiscellaneous.Codeunit.al", "AL", 206, 0, 0, 26, 37, 269
"c:\Users\jh\OneDrive - Scanpan\Scanpan (7.1.2015)\Development\SCANPAN Internal CodeBase\src\codeunit\SubscriberCU.Codeunit.al", "AL", 57, 0, 0, 2, 6, 65
"c:\Users\jh\OneDrive - Scanpan\Scanpan (7.1.2015)\Development\SCANPAN Internal CodeBase\src\codeunit\TESTCU.Codeunit.al", "AL", 0, 0, 0, 23, -2, 21
"c:\Users\jh\OneDrive - Scanpan\Scanpan (7.1.2015)\Development\SCANPAN Internal CodeBase\src\enum\CampaignStatisticsDocTypes.Enum.al", "AL", -4, 0, 0, 0, -3, -7
"c:\Users\jh\OneDrive - Scanpan\Scanpan (7.1.2015)\Development\SCANPAN Internal CodeBase\src\page Ext\CampaignCard.PageExt.al", "AL", 7, 0, 0, 7, 2, 16
"c:\Users\jh\OneDrive - Scanpan\Scanpan (7.1.2015)\Development\SCANPAN Internal CodeBase\src\page Ext\InventorySetup.PageExt.al", "AL", 65, 0, 0, 9, 3, 77
"c:\Users\jh\OneDrive - Scanpan\Scanpan (7.1.2015)\Development\SCANPAN Internal CodeBase\src\page Ext\InventorySetupExtSC.PageExt.al", "AL", -55, 0, 0, -9, -8, -72
"c:\Users\jh\OneDrive - Scanpan\Scanpan (7.1.2015)\Development\SCANPAN Internal CodeBase\src\page Ext\ItemList.PageExt.al", "AL", 66, 0, 0, 27, 12, 105
"c:\Users\jh\OneDrive - Scanpan\Scanpan (7.1.2015)\Development\SCANPAN Internal CodeBase\src\page Ext\ItemListExtSC.PageExt.al", "AL", -48, 0, 0, -26, -17, -91
"c:\Users\jh\OneDrive - Scanpan\Scanpan (7.1.2015)\Development\SCANPAN Internal CodeBase\src\page Ext\ProdBOMWhereUsed.PageExt.al", "AL", 50, 0, 0, 4, 13, 67
"c:\Users\jh\OneDrive - Scanpan\Scanpan (7.1.2015)\Development\SCANPAN Internal CodeBase\src\page\BCTABLEINFORMATIONSC.Page.al", "AL", 0, 0, 0, 0, 1, 1
"c:\Users\jh\OneDrive - Scanpan\Scanpan (7.1.2015)\Development\SCANPAN Internal CodeBase\src\page\CampaignSales.Page.al", "AL", -26, 0, 0, -6, -19, -51
"c:\Users\jh\OneDrive - Scanpan\Scanpan (7.1.2015)\Development\SCANPAN Internal CodeBase\src\page\ProdDeleteBomComponents.Page.al", "AL", 39, 0, 0, 0, 12, 51
"c:\Users\jh\OneDrive - Scanpan\Scanpan (7.1.2015)\Development\SCANPAN Internal CodeBase\src\page\ScanpanSetup.Page.al", "AL", 3, 0, 0, 24, 5, 32
"c:\Users\jh\OneDrive - Scanpan\Scanpan (7.1.2015)\Development\SCANPAN Internal CodeBase\src\page\TestPage.Page.al", "AL", -211, 0, 0, -52, -62, -325
"c:\Users\jh\OneDrive - Scanpan\Scanpan (7.1.2015)\Development\SCANPAN Internal CodeBase\src\table ext\InventorySetup.TableExt.al", "AL", 22, 0, 0, 12, 7, 41
"c:\Users\jh\OneDrive - Scanpan\Scanpan (7.1.2015)\Development\SCANPAN Internal CodeBase\src\table ext\InventorySetupExtSC.TableExt.al", "AL", -18, 0, 0, -9, -4, -31
"c:\Users\jh\OneDrive - Scanpan\Scanpan (7.1.2015)\Development\SCANPAN Internal CodeBase\src\table ext\ItemExt.TableExt.al", "AL", 54, 0, 0, 12, 3, 69
"c:\Users\jh\OneDrive - Scanpan\Scanpan (7.1.2015)\Development\SCANPAN Internal CodeBase\src\table ext\ItemExtSC.TableExt.al", "AL", -33, 0, 0, -10, -2, -45
"c:\Users\jh\OneDrive - Scanpan\Scanpan (7.1.2015)\Development\SCANPAN Internal CodeBase\src\table\CampaignStatistics.Table.al", "AL", 21, 0, 0, 0, 0, 21
"c:\Users\jh\OneDrive - Scanpan\Scanpan (7.1.2015)\Development\SCANPAN Internal CodeBase\translations\SCANPAN CODEBASE Internal Development.da-DK.xlf", "XML", 0, 0, 217, 0, 0, 217
"c:\Users\jh\OneDrive - Scanpan\Scanpan (7.1.2015)\Development\SCANPAN Internal CodeBase\translations\SCANPAN CODEBASE Internal Development.en-GB.xlf", "XML", 0, 0, 212, 0, 0, 212
"c:\Users\jh\OneDrive - Scanpan\Scanpan (7.1.2015)\Development\SCANPAN Internal CodeBase\translations\SCANPAN CODEBASE Internal Development.g.xlf", "XML", 0, 0, 175, 0, 0, 175
"Total", "-", 246, 62522, 604, 49, 329, 63750