"filename", "language", "AL", "HTTP", "JSON", "alapp", "XML", "comment", "blank", "total"
"c:\Users\jh\OneDrive - Scanpan\Scanpan (7.1.2015)\Development\SCANPAN Internal CodeBase\SCANPAN_SCANPAN CODEBASE Internal Development_1.0.0.43.app", "alapp", 0, 0, 0, -3478, 0, 0, -15, -3493
"c:\Users\jh\OneDrive - Scanpan\Scanpan (7.1.2015)\Development\SCANPAN Internal CodeBase\SCANPAN_SCANPAN CODEBASE Internal Development_1.0.0.44.app", "alapp", 0, 0, 0, -3677, 0, 0, -21, -3698
"c:\Users\jh\OneDrive - Scanpan\Scanpan (7.1.2015)\Development\SCANPAN Internal CodeBase\SCANPAN_SCANPAN CODEBASE Internal Development_1.0.0.48.app", "alapp", 0, 0, 0, 4148, 0, 0, 22, 4170
"c:\Users\jh\OneDrive - Scanpan\Scanpan (7.1.2015)\Development\SCANPAN Internal CodeBase\SCANPAN_SCANPAN CODEBASE Internal Development_1.0.23.7190832.app", "alapp", 0, 0, 0, 4554, 0, 0, 22, 4576
"c:\Users\jh\OneDrive - Scanpan\Scanpan (7.1.2015)\Development\SCANPAN Internal CodeBase\SCANPAN_SCANPAN CODEBASE Internal Development_1.0.23.7190833.app", "alapp", 0, 0, 0, 4139, 0, 0, 22, 4161
"c:\Users\jh\OneDrive - Scanpan\Scanpan (7.1.2015)\Development\SCANPAN Internal CodeBase\SCANPAN_SCANPAN CODEBASE Internal Development_1.0.23.7190835.app", "alapp", 0, 0, 0, 4138, 0, 0, 21, 4159
"c:\Users\jh\OneDrive - Scanpan\Scanpan (7.1.2015)\Development\SCANPAN Internal CodeBase\SCANPAN_SCANPAN CODEBASE Internal Development_1.0.23.7190855.app", "alapp", 0, 0, 0, 4147, 0, 0, 22, 4169
"c:\Users\jh\OneDrive - Scanpan\Scanpan (7.1.2015)\Development\SCANPAN Internal CodeBase\SCANPAN_SCANPAN CODEBASE Internal Development_1.0.23.7191041.app", "alapp", 0, 0, 0, 4137, 0, 0, 22, 4159
"c:\Users\jh\OneDrive - Scanpan\Scanpan (7.1.2015)\Development\SCANPAN Internal CodeBase\SCANPAN_SCANPAN CODEBASE Internal Development_1.0.23.7191132.app", "alapp", 0, 0, 0, 4152, 0, 0, 22, 4174
"c:\Users\jh\OneDrive - Scanpan\Scanpan (7.1.2015)\Development\SCANPAN Internal CodeBase\SCANPAN_SCANPAN CODEBASE Internal Development_1.0.23.7191141.app", "alapp", 0, 0, 0, 4180, 0, 0, 20, 4200
"c:\Users\jh\OneDrive - Scanpan\Scanpan (7.1.2015)\Development\SCANPAN Internal CodeBase\SCANPAN_SCANPAN CODEBASE Internal Development_1.0.23.7191325.app", "alapp", 0, 0, 0, 4204, 0, 0, 17, 4221
"c:\Users\jh\OneDrive - Scanpan\Scanpan (7.1.2015)\Development\SCANPAN Internal CodeBase\SCANPAN_SCANPAN CODEBASE Internal Development_1.0.23.7191330.app", "alapp", 0, 0, 0, 4115, 0, 0, 20, 4135
"c:\Users\jh\OneDrive - Scanpan\Scanpan (7.1.2015)\Development\SCANPAN Internal CodeBase\SCANPAN_SCANPAN CODEBASE Internal Development_1.0.23.7191333.app", "alapp", 0, 0, 0, 4154, 0, 0, 22, 4176
"c:\Users\jh\OneDrive - Scanpan\Scanpan (7.1.2015)\Development\SCANPAN Internal CodeBase\SnapshotDebugging.al", "AL", 0, 0, 0, 0, 0, 0, 1, 1
"c:\Users\jh\OneDrive - Scanpan\Scanpan (7.1.2015)\Development\SCANPAN Internal CodeBase\app.json", "JSON", 0, 0, -1, 0, 0, 0, -4, -5
"c:\Users\jh\OneDrive - Scanpan\Scanpan (7.1.2015)\Development\SCANPAN Internal CodeBase\old_app_codebase\SCANPAN_SCANPAN CODEBASE Internal Development_1.0.0.43.app", "alapp", 0, 0, 0, 3478, 0, 0, 15, 3493
"c:\Users\jh\OneDrive - Scanpan\Scanpan (7.1.2015)\Development\SCANPAN Internal CodeBase\old_app_codebase\SCANPAN_SCANPAN CODEBASE Internal Development_1.0.0.44.app", "alapp", 0, 0, 0, 3619, 0, 0, 19, 3638
"c:\Users\jh\OneDrive - Scanpan\Scanpan (7.1.2015)\Development\SCANPAN Internal CodeBase\old_app_codebase\SCANPAN_SCANPAN CODEBASE Internal Development_1.0.0.45.app", "alapp", 0, 0, 0, 3798, 0, 0, 17, 3815
"c:\Users\jh\OneDrive - Scanpan\Scanpan (7.1.2015)\Development\SCANPAN Internal CodeBase\old_app_codebase\SCANPAN_SCANPAN CODEBASE Internal Development_1.0.0.46.app", "alapp", 0, 0, 0, 3875, 0, 0, 22, 3897
"c:\Users\jh\OneDrive - Scanpan\Scanpan (7.1.2015)\Development\SCANPAN Internal CodeBase\old_app_codebase\SCANPAN_SCANPAN CODEBASE Internal Development_1.0.0.47.app", "alapp", 0, 0, 0, 4189, 0, 0, 20, 4209
"c:\Users\jh\OneDrive - Scanpan\Scanpan (7.1.2015)\Development\SCANPAN Internal CodeBase\old_app_codebase\SCANPAN_SCANPAN CODEBASE Internal Development_1.0.0.48.app", "alapp", 0, 0, 0, 4134, 0, 0, 23, 4157
"c:\Users\jh\OneDrive - Scanpan\Scanpan (7.1.2015)\Development\SCANPAN Internal CodeBase\src\codeunit\CompanyTestDetection.Codeunit.al", "AL", 20, 0, 0, 0, 0, 3, 6, 29
"c:\Users\jh\OneDrive - Scanpan\Scanpan (7.1.2015)\Development\SCANPAN Internal CodeBase\src\codeunit\PIMimages.Codeunit.al", "AL", -2, 0, 0, 0, 0, 0, 1, -1
"c:\Users\jh\OneDrive - Scanpan\Scanpan (7.1.2015)\Development\SCANPAN Internal CodeBase\src\codeunit\ScanpanMiscellaneous.Codeunit.al", "AL", 5, 0, 0, 0, 0, 4, 3, 12
"c:\Users\jh\OneDrive - Scanpan\Scanpan (7.1.2015)\Development\SCANPAN Internal CodeBase\src\codeunit\SubscriberCU.Codeunit.al", "AL", 39, 0, 0, 0, 0, 12, -8, 43
"c:\Users\jh\OneDrive - Scanpan\Scanpan (7.1.2015)\Development\SCANPAN Internal CodeBase\src\codeunit\TESTCU.Codeunit.al", "AL", 3, 0, 0, 0, 0, 3, 7, 13
"c:\Users\jh\OneDrive - Scanpan\Scanpan (7.1.2015)\Development\SCANPAN Internal CodeBase\src\codeunit\TestCompany.Codeunit.al", "AL", -3, 0, 0, 0, 0, -3, -5, -11
"c:\Users\jh\OneDrive - Scanpan\Scanpan (7.1.2015)\Development\SCANPAN Internal CodeBase\src\enum\CampaignStatisticsDocTypes.Enum.al", "AL", 20, 0, 0, 0, 0, 6, 6, 32
"c:\Users\jh\OneDrive - Scanpan\Scanpan (7.1.2015)\Development\SCANPAN Internal CodeBase\src\page Ext\BankAccountLedgerEntriesExtSC.PageExt.al", "AL", 4, 0, 0, 0, 0, 0, -6, -2
"c:\Users\jh\OneDrive - Scanpan\Scanpan (7.1.2015)\Development\SCANPAN Internal CodeBase\src\page Ext\BinContentsExtSC.PageExt.al", "AL", 9, 0, 0, 0, 0, 0, -7, 2
"c:\Users\jh\OneDrive - Scanpan\Scanpan (7.1.2015)\Development\SCANPAN Internal CodeBase\src\page Ext\CDOUnhandledPurchaseOrderExtSC.PageExt.al", "AL", 8, 0, 0, 0, 0, 0, 0, 8
"c:\Users\jh\OneDrive - Scanpan\Scanpan (7.1.2015)\Development\SCANPAN Internal CodeBase\src\page Ext\CampaignListExtSC.PageExt.al", "AL", 7, 0, 0, 0, 0, 0, 0, 7
"c:\Users\jh\OneDrive - Scanpan\Scanpan (7.1.2015)\Development\SCANPAN Internal CodeBase\src\page Ext\CustomerCardExtSC.PageExt.al", "AL", 8, 0, 0, 0, 0, 5, 2, 15
"c:\Users\jh\OneDrive - Scanpan\Scanpan (7.1.2015)\Development\SCANPAN Internal CodeBase\src\page Ext\GeneralJournalExtSC.PageExt.al", "AL", 19, 0, 0, 0, 0, 0, 0, 19
"c:\Users\jh\OneDrive - Scanpan\Scanpan (7.1.2015)\Development\SCANPAN Internal CodeBase\src\page Ext\GetShipmentLines.PageExt.al", "AL", 17, 0, 0, 0, 0, 8, 7, 32
"c:\Users\jh\OneDrive - Scanpan\Scanpan (7.1.2015)\Development\SCANPAN Internal CodeBase\src\page Ext\IDYSTransportOrderCard.PageExt.al", "AL", 31, 0, 0, 0, 0, 3, 7, 41
"c:\Users\jh\OneDrive - Scanpan\Scanpan (7.1.2015)\Development\SCANPAN Internal CodeBase\src\page Ext\ITIIICDocumentLogEntriesExtSC.PageExt.al", "AL", 8, 0, 0, 0, 0, 0, 0, 8
"c:\Users\jh\OneDrive - Scanpan\Scanpan (7.1.2015)\Development\SCANPAN Internal CodeBase\src\page Ext\ItemJournalExtSC.PageExt.al", "AL", 9, 0, 0, 0, 0, 0, 0, 9
"c:\Users\jh\OneDrive - Scanpan\Scanpan (7.1.2015)\Development\SCANPAN Internal CodeBase\src\page Ext\MOSLicensePlateContentExtSC.PageExt.al", "AL", 8, 0, 0, 0, 0, 0, 0, 8
"c:\Users\jh\OneDrive - Scanpan\Scanpan (7.1.2015)\Development\SCANPAN Internal CodeBase\src\page Ext\NOTOTransferOrderLinesExtSC.PageExt.al", "AL", 4, 0, 0, 0, 0, 0, 0, 4
"c:\Users\jh\OneDrive - Scanpan\Scanpan (7.1.2015)\Development\SCANPAN Internal CodeBase\src\page Ext\PlanningWorksheetExtSC.PageExt.al", "AL", 1, 0, 0, 0, 0, 0, 0, 1
"c:\Users\jh\OneDrive - Scanpan\Scanpan (7.1.2015)\Development\SCANPAN Internal CodeBase\src\page Ext\PostedPurchaseInvoicesExtSC.PageExt.al", "AL", 8, 0, 0, 0, 0, 0, 0, 8
"c:\Users\jh\OneDrive - Scanpan\Scanpan (7.1.2015)\Development\SCANPAN Internal CodeBase\src\page Ext\PostedSalesInvociesExtSC.PageExt.al", "AL", 8, 0, 0, 0, 0, 0, 0, 8
"c:\Users\jh\OneDrive - Scanpan\Scanpan (7.1.2015)\Development\SCANPAN Internal CodeBase\src\page Ext\PostedSalesInvoiceExtSC.PageExt.al", "AL", 20, 0, 0, 0, 0, 0, 0, 20
"c:\Users\jh\OneDrive - Scanpan\Scanpan (7.1.2015)\Development\SCANPAN Internal CodeBase\src\page Ext\PostedSalesInvoiceSubform.PageExt.al", "AL", 7, 0, 0, 0, 0, 6, 3, 16
"c:\Users\jh\OneDrive - Scanpan\Scanpan (7.1.2015)\Development\SCANPAN Internal CodeBase\src\page Ext\PostedSalesShipment.PageExt.al", "AL", 10, 0, 0, 0, 0, 0, -1, 9
"c:\Users\jh\OneDrive - Scanpan\Scanpan (7.1.2015)\Development\SCANPAN Internal CodeBase\src\page Ext\PostedSalesShipments.PageExt.al", "AL", 26, 0, 0, 0, 0, 0, 0, 26
"c:\Users\jh\OneDrive - Scanpan\Scanpan (7.1.2015)\Development\SCANPAN Internal CodeBase\src\page Ext\PostedSalesShptSubform.PageExt.al", "AL", 15, 0, 0, 0, 0, 6, 7, 28
"c:\Users\jh\OneDrive - Scanpan\Scanpan (7.1.2015)\Development\SCANPAN Internal CodeBase\src\page Ext\PostedWhseShipment.PageExt.al", "AL", 16, 0, 0, 0, 0, 8, 7, 31
"c:\Users\jh\OneDrive - Scanpan\Scanpan (7.1.2015)\Development\SCANPAN Internal CodeBase\src\page Ext\PostedWhseShipmentList.PageExt.al", "AL", 13, 0, 0, 0, 0, 8, 5, 26
"c:\Users\jh\OneDrive - Scanpan\Scanpan (7.1.2015)\Development\SCANPAN Internal CodeBase\src\page Ext\PostedWhseShipmentSubform.PageExt.al", "AL", 15, 0, 0, 0, 0, 6, 9, 30
"c:\Users\jh\OneDrive - Scanpan\Scanpan (7.1.2015)\Development\SCANPAN Internal CodeBase\src\page Ext\PriceListLinesExtSC.PageExt.al", "AL", 8, 0, 0, 0, 0, 0, 0, 8
"c:\Users\jh\OneDrive - Scanpan\Scanpan (7.1.2015)\Development\SCANPAN Internal CodeBase\src\page Ext\ProdOrderComponentsExt.PageExt.al", "AL", 1, 0, 0, 0, 0, 0, 0, 1
"c:\Users\jh\OneDrive - Scanpan\Scanpan (7.1.2015)\Development\SCANPAN Internal CodeBase\src\page Ext\ProdOrderRoutingExtSC.PageExt.al", "AL", 4, 0, 0, 0, 0, 0, 0, 4
"c:\Users\jh\OneDrive - Scanpan\Scanpan (7.1.2015)\Development\SCANPAN Internal CodeBase\src\page Ext\ProductionJournalExtSC.PageExt.al", "AL", 12, 0, 0, 0, 0, 0, 0, 12
"c:\Users\jh\OneDrive - Scanpan\Scanpan (7.1.2015)\Development\SCANPAN Internal CodeBase\src\page Ext\PuhCrMemoSubform.PageExt.al", "AL", 22, 0, 0, 0, 0, 3, 4, 29
"c:\Users\jh\OneDrive - Scanpan\Scanpan (7.1.2015)\Development\SCANPAN Internal CodeBase\src\page Ext\PurchaseOrderListExtSC.PageExt.al", "AL", 4, 0, 0, 0, 0, 0, 0, 4
"c:\Users\jh\OneDrive - Scanpan\Scanpan (7.1.2015)\Development\SCANPAN Internal CodeBase\src\page Ext\PurchaseOrderSubformExtSC.PageExt.al", "AL", 5, 0, 0, 0, 0, 0, 2, 7
"c:\Users\jh\OneDrive - Scanpan\Scanpan (7.1.2015)\Development\SCANPAN Internal CodeBase\src\page Ext\PurchasePriceListsExtSC.PageExt.al", "AL", 4, 0, 0, 0, 0, 0, 0, 4
"c:\Users\jh\OneDrive - Scanpan\Scanpan (7.1.2015)\Development\SCANPAN Internal CodeBase\src\page Ext\ReleasedProductionOrder.PageExt.al", "AL", 10, 0, 0, 0, 0, 0, 0, 10
"c:\Users\jh\OneDrive - Scanpan\Scanpan (7.1.2015)\Development\SCANPAN Internal CodeBase\src\page Ext\RoutingList.PageExt.al", "AL", 1, 0, 0, 0, 0, 3, 0, 4
"c:\Users\jh\OneDrive - Scanpan\Scanpan (7.1.2015)\Development\SCANPAN Internal CodeBase\src\page Ext\RoutingToolsExtSC.PageExt.al", "AL", -8, 0, 0, 0, 0, -3, -1, -12
"c:\Users\jh\OneDrive - Scanpan\Scanpan (7.1.2015)\Development\SCANPAN Internal CodeBase\src\page Ext\SCANPANRoutingLines.PageExt.al", "AL", 8, 0, 0, 0, 0, 3, 8, 19
"c:\Users\jh\OneDrive - Scanpan\Scanpan (7.1.2015)\Development\SCANPAN Internal CodeBase\src\page Ext\SalesInvoiceSubformExtSC.PageExt.al", "AL", 16, 0, 0, 0, 0, 0, 0, 16
"c:\Users\jh\OneDrive - Scanpan\Scanpan (7.1.2015)\Development\SCANPAN Internal CodeBase\src\page Ext\SalesLines.PageExt.al", "AL", 1, 0, 0, 0, 0, 3, 0, 4
"c:\Users\jh\OneDrive - Scanpan\Scanpan (7.1.2015)\Development\SCANPAN Internal CodeBase\src\page Ext\SalesOrder.PageExt.al", "AL", 33, 0, 0, 0, 0, 1, 2, 36
"c:\Users\jh\OneDrive - Scanpan\Scanpan (7.1.2015)\Development\SCANPAN Internal CodeBase\src\page Ext\SalesOrderList.PageExt.al", "AL", 12, 0, 0, 0, 0, 3, 3, 18
"c:\Users\jh\OneDrive - Scanpan\Scanpan (7.1.2015)\Development\SCANPAN Internal CodeBase\src\page Ext\SalesOrderSubformExtSC.PageExt.al", "AL", 25, 0, 0, 0, 0, 0, 1, 26
"c:\Users\jh\OneDrive - Scanpan\Scanpan (7.1.2015)\Development\SCANPAN Internal CodeBase\src\page Ext\SalesPriceListsExtSC.PageExt.al", "AL", 4, 0, 0, 0, 0, 0, 0, 4
"c:\Users\jh\OneDrive - Scanpan\Scanpan (7.1.2015)\Development\SCANPAN Internal CodeBase\src\page Ext\ShopCalendarHolidays.PageExt.al", "AL", 5, 0, 0, 0, 0, 0, 0, 5
"c:\Users\jh\OneDrive - Scanpan\Scanpan (7.1.2015)\Development\SCANPAN Internal CodeBase\src\page Ext\StockkeepingUnitListExtSC.PageExt.al", "AL", 16, 0, 0, 0, 0, 0, 0, 16
"c:\Users\jh\OneDrive - Scanpan\Scanpan (7.1.2015)\Development\SCANPAN Internal CodeBase\src\page Ext\TransferOrders.PageExt.al", "AL", 1, 0, 0, 0, 0, 3, 0, 4
"c:\Users\jh\OneDrive - Scanpan\Scanpan (7.1.2015)\Development\SCANPAN Internal CodeBase\src\page Ext\TransportOrderLineSub.PageExt.al", "AL", 15, 0, 0, 0, 0, 8, 7, 30
"c:\Users\jh\OneDrive - Scanpan\Scanpan (7.1.2015)\Development\SCANPAN Internal CodeBase\src\page Ext\VendorList.PageExt.al", "AL", 0, 0, 0, 0, 0, 3, 0, 3
"c:\Users\jh\OneDrive - Scanpan\Scanpan (7.1.2015)\Development\SCANPAN Internal CodeBase\src\page Ext\WarehousePicks.PageExt.al", "AL", 48, 0, 0, 0, 0, 9, 7, 64
"c:\Users\jh\OneDrive - Scanpan\Scanpan (7.1.2015)\Development\SCANPAN Internal CodeBase\src\page Ext\WarehouseShipmentExtSC.PageExt.al", "AL", 8, 0, 0, 0, 0, 8, 0, 16
"c:\Users\jh\OneDrive - Scanpan\Scanpan (7.1.2015)\Development\SCANPAN Internal CodeBase\src\page Ext\WarehouseShipmentListExtSC.PageExt.al", "AL", 12, 0, 0, 0, 0, 0, 0, 12
"c:\Users\jh\OneDrive - Scanpan\Scanpan (7.1.2015)\Development\SCANPAN Internal CodeBase\src\page Ext\WhseShipmentSubformExtSC.PageExt.al", "AL", 8, 0, 0, 0, 0, 0, 0, 8
"c:\Users\jh\OneDrive - Scanpan\Scanpan (7.1.2015)\Development\SCANPAN Internal CodeBase\src\page role\WhseWorkerWMSRoleCenterExtSC.PageExt.al", "AL", 8, 0, 0, 0, 0, 0, 1, 9
"c:\Users\jh\OneDrive - Scanpan\Scanpan (7.1.2015)\Development\SCANPAN Internal CodeBase\src\page\CampaignSales.Page.al", "AL", 277, 0, 0, 0, 0, 13, 36, 326
"c:\Users\jh\OneDrive - Scanpan\Scanpan (7.1.2015)\Development\SCANPAN Internal CodeBase\src\page\CreateItemBarcodeSC.Page.al", "AL", 3, 0, 0, 0, 0, 0, -6, -3
"c:\Users\jh\OneDrive - Scanpan\Scanpan (7.1.2015)\Development\SCANPAN Internal CodeBase\src\page\ExtSalesCustomerSales.Page.al", "AL", 2, 0, 0, 0, 0, 0, -19, -17
"c:\Users\jh\OneDrive - Scanpan\Scanpan (7.1.2015)\Development\SCANPAN Internal CodeBase\src\page\ExtSalesItemListSC.Page.al", "AL", -2, 0, 0, 0, 0, 0, -5, -7
"c:\Users\jh\OneDrive - Scanpan\Scanpan (7.1.2015)\Development\SCANPAN Internal CodeBase\src\page\ExtSalesLinesSC.Page.al", "AL", -3, 0, 0, 0, 0, -1, -16, -20
"c:\Users\jh\OneDrive - Scanpan\Scanpan (7.1.2015)\Development\SCANPAN Internal CodeBase\src\page\ExtSalesMapSalespersonSC.Page.al", "AL", 2, 0, 0, 0, 0, 0, 0, 2
"c:\Users\jh\OneDrive - Scanpan\Scanpan (7.1.2015)\Development\SCANPAN Internal CodeBase\src\page\IICTrackingBC.Page.al", "AL", 19, 0, 0, 0, 0, 0, 0, 19
"c:\Users\jh\OneDrive - Scanpan\Scanpan (7.1.2015)\Development\SCANPAN Internal CodeBase\src\page\InventoryMapShelfNoSC.Page.al", "AL", 6, 0, 0, 0, 0, -1, -6, -1
"c:\Users\jh\OneDrive - Scanpan\Scanpan (7.1.2015)\Development\SCANPAN Internal CodeBase\src\page\InventoryRessources.Page.al", "AL", 6, 0, 0, 0, 0, 0, 0, 6
"c:\Users\jh\OneDrive - Scanpan\Scanpan (7.1.2015)\Development\SCANPAN Internal CodeBase\src\page\PictureURLDialog.Page.al", "AL", 5, 0, 0, 0, 0, 0, -5, 0
"c:\Users\jh\OneDrive - Scanpan\Scanpan (7.1.2015)\Development\SCANPAN Internal CodeBase\src\page\ProdControlListRoutingLine.Page.al", "AL", 0, 0, 0, 0, 0, 0, -4, -4
"c:\Users\jh\OneDrive - Scanpan\Scanpan (7.1.2015)\Development\SCANPAN Internal CodeBase\src\page\ProdControllingPanPlan.Page.al", "AL", 4, 0, 0, 0, 0, -1, -3, 0
"c:\Users\jh\OneDrive - Scanpan\Scanpan (7.1.2015)\Development\SCANPAN Internal CodeBase\src\page\ProdControllingRoutingLine.Page.al", "AL", 20, 0, 0, 0, 0, 0, -1, 19
"c:\Users\jh\OneDrive - Scanpan\Scanpan (7.1.2015)\Development\SCANPAN Internal CodeBase\src\page\ProductionControlling.Page.al", "AL", 23, 0, 0, 0, 0, 0, -7, 16
"c:\Users\jh\OneDrive - Scanpan\Scanpan (7.1.2015)\Development\SCANPAN Internal CodeBase\src\page\PurchLinesSC.Page.al", "AL", 4, 0, 0, 0, 0, 0, -8, -4
"c:\Users\jh\OneDrive - Scanpan\Scanpan (7.1.2015)\Development\SCANPAN Internal CodeBase\src\page\REST_http.http", "HTTP", 0, 24, 0, 0, 0, 0, 7, 31
"c:\Users\jh\OneDrive - Scanpan\Scanpan (7.1.2015)\Development\SCANPAN Internal CodeBase\src\page\SalesCommission.Page.al", "AL", 431, 0, 0, 0, 0, 31, 46, 508
"c:\Users\jh\OneDrive - Scanpan\Scanpan (7.1.2015)\Development\SCANPAN Internal CodeBase\src\page\SalesDocumentsStatistics.Page.al", "AL", -411, 0, 0, 0, 0, -27, -54, -492
"c:\Users\jh\OneDrive - Scanpan\Scanpan (7.1.2015)\Development\SCANPAN Internal CodeBase\src\page\SalesLine.Page.al", "AL", 30, 0, 0, 0, 0, 0, -8, 22
"c:\Users\jh\OneDrive - Scanpan\Scanpan (7.1.2015)\Development\SCANPAN Internal CodeBase\src\page\SalesLineSubform.Page.al", "AL", -1, 0, 0, 0, 0, -2, -40, -43
"c:\Users\jh\OneDrive - Scanpan\Scanpan (7.1.2015)\Development\SCANPAN Internal CodeBase\src\page\SalespriceSubPageSC.Page.al", "AL", -2, 0, 0, 0, 0, -1, 4, 1
"c:\Users\jh\OneDrive - Scanpan\Scanpan (7.1.2015)\Development\SCANPAN Internal CodeBase\src\page\SalespricelistCardSC.Page.al", "AL", -13, 0, 0, 0, 0, 0, -19, -32
"c:\Users\jh\OneDrive - Scanpan\Scanpan (7.1.2015)\Development\SCANPAN Internal CodeBase\src\page\SearchAndReplace.Page.al", "AL", 62, 0, 0, 0, 0, 4, 15, 81
"c:\Users\jh\OneDrive - Scanpan\Scanpan (7.1.2015)\Development\SCANPAN Internal CodeBase\src\page\ShipITdebug.Page.al", "AL", 54, 0, 0, 0, 0, 3, -4, 53
"c:\Users\jh\OneDrive - Scanpan\Scanpan (7.1.2015)\Development\SCANPAN Internal CodeBase\src\page\TestPage.Page.al", "AL", 25, 0, 0, 0, 0, 4, 5, 34
"c:\Users\jh\OneDrive - Scanpan\Scanpan (7.1.2015)\Development\SCANPAN Internal CodeBase\src\page\WMSPickBinBalanceSC.Page.al", "AL", 8, 0, 0, 0, 0, 0, 0, 8
"c:\Users\jh\OneDrive - Scanpan\Scanpan (7.1.2015)\Development\SCANPAN Internal CodeBase\src\page\WebServiceOrderFormCustomer.Page.al", "AL", 2, 0, 0, 0, 0, -2, -9, -9
"c:\Users\jh\OneDrive - Scanpan\Scanpan (7.1.2015)\Development\SCANPAN Internal CodeBase\src\page\WebServiceOrderFormItems.Page.al", "AL", 14, 0, 0, 0, 0, 0, -1, 13
"c:\Users\jh\OneDrive - Scanpan\Scanpan (7.1.2015)\Development\SCANPAN Internal CodeBase\src\page\WebServiceSalesPriceListSource.Page.al", "AL", 11, 0, 0, 0, 0, 0, -13, -2
"c:\Users\jh\OneDrive - Scanpan\Scanpan (7.1.2015)\Development\SCANPAN Internal CodeBase\src\report\PallelisteEksport50011.Report.al", "AL", 21, 0, 0, 0, 0, -4, 1, 18
"c:\Users\jh\OneDrive - Scanpan\Scanpan (7.1.2015)\Development\SCANPAN Internal CodeBase\src\table ext\BlankExtTest.TableExt.al", "AL", 0, 0, 0, 0, 0, -8, -3, -11
"c:\Users\jh\OneDrive - Scanpan\Scanpan (7.1.2015)\Development\SCANPAN Internal CodeBase\src\table ext\CustomerSC.TableExt.al", "AL", 7, 0, 0, 0, 0, 0, 0, 7
"c:\Users\jh\OneDrive - Scanpan\Scanpan (7.1.2015)\Development\SCANPAN Internal CodeBase\src\table ext\IDYSTransportOrderLine.TableExt.al", "AL", 8, 0, 0, 0, 0, 0, 0, 8
"c:\Users\jh\OneDrive - Scanpan\Scanpan (7.1.2015)\Development\SCANPAN Internal CodeBase\src\table ext\ItemExtSC.TableExt.al", "AL", 0, 0, 0, 0, 0, 0, -2, -2
"c:\Users\jh\OneDrive - Scanpan\Scanpan (7.1.2015)\Development\SCANPAN Internal CodeBase\src\table ext\ItemLedgerEntry.TableExt.al", "AL", 11, 0, 0, 0, 0, 9, 0, 20
"c:\Users\jh\OneDrive - Scanpan\Scanpan (7.1.2015)\Development\SCANPAN Internal CodeBase\src\table ext\ItemUnitofMeasureExtSC.TableExt.al", "AL", 0, 0, 0, 0, 0, 3, -1, 2
"c:\Users\jh\OneDrive - Scanpan\Scanpan (7.1.2015)\Development\SCANPAN Internal CodeBase\src\table ext\PostedWhseShipmentHeader.TableExt.al", "AL", 11, 0, 0, 0, 0, 8, 8, 27
"c:\Users\jh\OneDrive - Scanpan\Scanpan (7.1.2015)\Development\SCANPAN Internal CodeBase\src\table ext\PostedWhseShipmentLine.TableExt.al", "AL", 18, 0, 0, 0, 0, 6, 0, 24
"c:\Users\jh\OneDrive - Scanpan\Scanpan (7.1.2015)\Development\SCANPAN Internal CodeBase\src\table ext\ProdOrderLine.TableExt.al", "AL", 0, 0, 0, 0, 0, 3, 0, 3
"c:\Users\jh\OneDrive - Scanpan\Scanpan (7.1.2015)\Development\SCANPAN Internal CodeBase\src\table ext\ProductionOrderExtSC.TableExt.al", "AL", 0, 0, 0, 0, 0, 0, -6, -6
"c:\Users\jh\OneDrive - Scanpan\Scanpan (7.1.2015)\Development\SCANPAN Internal CodeBase\src\table ext\SalesHeaderSC.TableExt.al", "AL", 0, 0, 0, 0, 0, 0, -6, -6
"c:\Users\jh\OneDrive - Scanpan\Scanpan (7.1.2015)\Development\SCANPAN Internal CodeBase\src\table ext\SalesInvoiceLine.TableExt.al", "AL", 13, 0, 0, 0, 0, 6, 2, 21
"c:\Users\jh\OneDrive - Scanpan\Scanpan (7.1.2015)\Development\SCANPAN Internal CodeBase\src\table ext\SalesLineExtSC.TableExt.al", "AL", 0, 0, 0, 0, 0, 0, -4, -4
"c:\Users\jh\OneDrive - Scanpan\Scanpan (7.1.2015)\Development\SCANPAN Internal CodeBase\src\table ext\SalesShipmentHeader.TableExt.al", "AL", 12, 0, 0, 0, 0, 8, 5, 25
"c:\Users\jh\OneDrive - Scanpan\Scanpan (7.1.2015)\Development\SCANPAN Internal CodeBase\src\table ext\SalesShipmentLine.TableExt.al", "AL", 19, 0, 0, 0, 0, 6, 1, 26
"c:\Users\jh\OneDrive - Scanpan\Scanpan (7.1.2015)\Development\SCANPAN Internal CodeBase\src\table ext\ValueEntry.TableExt.al", "AL", 11, 0, 0, 0, 0, 8, 0, 19
"c:\Users\jh\OneDrive - Scanpan\Scanpan (7.1.2015)\Development\SCANPAN Internal CodeBase\src\table ext\WarehouseShipmentHeaderExtSC.TableExt.al", "AL", 6, 0, 0, 0, 0, 3, 0, 9
"c:\Users\jh\OneDrive - Scanpan\Scanpan (7.1.2015)\Development\SCANPAN Internal CodeBase\src\table\CampaignStatistics.Table.al", "AL", 115, 0, 0, 0, 0, 6, 7, 128
"c:\Users\jh\OneDrive - Scanpan\Scanpan (7.1.2015)\Development\SCANPAN Internal CodeBase\src\table\DocumentLines.Table.al", "AL", 6, 0, 0, 0, 0, 0, 0, 6
"c:\Users\jh\OneDrive - Scanpan\Scanpan (7.1.2015)\Development\SCANPAN Internal CodeBase\src\table\FieldSelectionTable.Table.al", "AL", 29, 0, 0, 0, 0, 3, 7, 39
"c:\Users\jh\OneDrive - Scanpan\Scanpan (7.1.2015)\Development\SCANPAN Internal CodeBase\translations\SCANPAN CODEBASE Internal Development.da-DK.xlf", "XML", 0, 0, 0, 0, 2179, 0, 0, 2179
"c:\Users\jh\OneDrive - Scanpan\Scanpan (7.1.2015)\Development\SCANPAN Internal CodeBase\translations\SCANPAN CODEBASE Internal Development.en-GB.xlf", "XML", 0, 0, 0, 0, 2165, 0, 0, 2165
"c:\Users\jh\OneDrive - Scanpan\Scanpan (7.1.2015)\Development\SCANPAN Internal CodeBase\translations\SCANPAN CODEBASE Internal Development.g.xlf", "XML", 0, 0, 0, 0, 1800, 0, 0, 1800
"Total", "-", 1499, 24, -1, 62006, 6144, 196, 280, 70148